ПО - Tarkvara TA
Процесс разработки ПО - Tarkvara arendusprotsess
Документация на ПО - Tarkvara dokumentatsioon
Проект - Projekt
ИТ проект - IT projekt
Бизнес-проект - Äriprojekt
Проект по разработке - Arendusprojekt
Проект по реализации - Realiseerimis projekt
Диаграмма Ганта - Gantti diagramm

критический путь проекта - projekti kriitiline tee
виды рисков в проекте - projekti riskide liigid
аутсортсинг - allhanke
краудсортсинг - rahvahanke
ИТ аудит - IT audiit
ERP системы - ERP süsteemid
ROI для оценки проектов - Projektide hindamiseks / ROI
Tacit - süsteemid Tacit
Knowledge Managment System - KMS - 
cистемы управления базами данных – какие знаете? Andmebaaside halduse süsteemid - MSSQL , XAMPP, PostgreSQL
Project Managment Tool - Projekti haldamise tarkvara - MS Project, Project Libre, Atlassian

mudel - модель
kasutusmalliskeem - диаграмма прецедентов
tegevusskeem - диаграмма активности / диаграмма деятельности

jadaskeem - диаграмма последовательностей
klassiskeem - диаграмма классов
koostööskeem - диаграмма взаимодейсвтия

olem - сущность
seos - связь
andmebaasiskeem - диаграмма базы данных

muster - узор/схема/шаблон
mustand - черновик

punkt - точка
romb - ромб
ristkülik - прямоугольник
nool - стрелка
joon - линия
algussõlm - начальный узел
ovaal - овал

kavand - план, схема, макет
kavandamine - планирование

driver - utiliitprogramm, mis teeb lisaseadmed operatsioonisüsteemile kättesaadavaks ja kasutatavaks
andmetöötlussüsteem - riistvarast, tarkvarast ja inimestest koosnev süsteem andmete muutmiseks kasutatavaks informatsiooniks
rakendustarkvara - programmid, millega saab inimene arvutis midagi kasulikku teha
bios - osa süsteemist, mis on vajalik sisesndi ja väljundi jaoks
süsteemi tarkvara - kõik programmid, mis tagavad, et arvuti ja tema lisaseadmed suudaksid koos funktsioneerida


versioonihaldussüsteem - система управления версиями
